1111111111111111111111111111111
1000000000000000001100000000001
1000111111111111111100111111001
1000000000011000000100000001001
1111111110011111100111111111001
1000000010010000000000000000001
1000000010010000000000011111111
1001111110000000000000000000001
1000000000000000000000000000001
1111111100000111100000000000001
1111111110000111100011111110001
1000000000000000000011011000001
1000000011111111111111001001111
1111110000000001100000000001111
1001110001111001100011111100001
1000000001111000000011111110001
1111111111111111111111111111111
